00000100
00000111
00011110
11000000
00100001
00001111
00001011
01000000