11100100
00110111
00011110
11111000
00100001
00111111
00001011
01111100